#################
#               #
#    X         O#
# X      ########
#      X   O    #
######          #
#O  ##   P    ###
#   ##     O    #
#      X      X #
#O       ########
#################
