########
#OX  XO#
#   P  #
#    XO#
########
